....................
.XXXXXXXXXXXXXXXXXX.
.X.X.X.X.XX.X.X.X.X.
.XXXXXXXXXXXXXXXXXX.
.X.X.X.X.XX.X.X.X.X.
.XXXXXXXXXXXXXXXXXX.
....................
..XX..XX....XX..XX..
..XX..XX....XX..XX..
....................
....................
....................
....................
....................
....................
